some words that i lern while estuden english.

starting...

some : tradução literal é alguma, something, alguma coisa, algo

that : essa, esse, aquilo, que
 
such : tal, assim, 

while : enquanto

ever : nunca, já, jamais, sempre

met : conhecer, conheceu 

lern : aprender

writed : escrito

sure does : com certeza

sure i do : claro que something

stop > stopeed : parar > parou

each : cada, cada um
 to each : para cada 
   to each they : para cada um deles
   
kind : gentil, meio 
 it's kinda > é meio...
   i think it's kind > eu acho que é meio
   
know : conhecer, saber, entender

because : porque... 

was : era, pode ser usado para representar outro tempo verbal, i was > eu estava, we was > nós eramos

as : como, tão. 

happen : acontecer, ocorreu, 
 happend : aconteceu
  happeding : acontecendo
  
bump : colisão, o choque, impacto 
 bump to you > bater em você 
  i bump to you > e esbarrei em você
   
right : certo
place : lugar
 right place > lugar certo 
 
at > na
 at the time right 
 
 existe uma regra de quando usar o the e quando não usar ele, pesquisar sobre depois
 
 


ing, ed no fim das palavras:

ing : lern > lerning > aprendendo / writing > esvrevendo e não esvrever

ed : writed > escrito, it is writed... > está escrito... 